R 900 600
NO pics/eagle.xpm
SO pics/bluestone.xpm
WE pics/redbrick.xpm
EA pics/colorstone.xpm

S  pics/barrel.xpm

F 184,113,39
C 51,198,227

        1111111111111111111111111
        1000000000110000000111211
        1011000001110000020110001
        1021000000000000000110001
111111111011000001110000000000001
100000000011000001110111111111111
11110111111111011100000010001
11110111111111011121010010001
11000000110101011100000012001
10002000000000001100000000001
10000000000000001101010010001
11000001110101011111211110N0111
11110111 1112101 101111010001
11111111 1111111 111111111111
