R 500 500
NO ./pics/eagle.xpm
SO ./pics/bluestone.xpm
WE ./pics/redbrick.xpm
EA ./pics/wood.xpm

S ./pics/barrel.xpm
F 100,50,10
C 50,168,133

1111111111111
1000000000001
1000000020001
1N00000000001
1111111111111
