R 500 500
NO ./pics/eagle.xpm
SO ./pics/bluestone.xpm
WE ./pics/redbrick.xpm
EA ./pics/wood.xpm

S ./pics/barrel.xpm
F 100,50,10
C 50,168,133

1111111111111111111
1200020000000000021
1000000002000111001
1001111000000000001
1000000000000020001
1000000000000000001
1001000000000020001
100000N000000000001
1200000000000000021
1111111111111111111
