R 500 500
NO ./pics/eagle.XPM
SO ./pics/bluestone.XPM
WE ./pics/redbrick.XPM
EA ./pics/greystone.XPM

S ./pics/barrel.XPM
F 100,50,10
C 50,168,133

1111111111111
1000000000001
1000000000001
1000000000001
10000N0000001
1000000000001
1000000000001
1000000000001
1000000000001
1111111111111
