R 500 500
NO ./pics/eagle.xpm
SO ./pics/bluestone.xpm
WE ./pics/redbrick.xpm
EA ./pics/wood.xpm

S ./pics/barrel.xpm
F 100,50,10
C 50,168,133

111111111
100000001
100000001
100200001
102N20001
111111111
