R 5000 5000
SO pics/eagle.xpm
NO pics/bluestone.xpm
EA pics/redbrick.xpm
WE pics/wood.xpm

S pics/barrel.xpm
F 100,50,10
C 12,168,133

11111111111111111111111111111
11110110000111000100000010001
11110110000111011101010010001
11000200110101010100000012001
1E000200000000000000000000001
10020000000000000000010100101
112002011101010111110111100111
11110110001101010001111010001
11111111111111111111111111111
